
# Setting PATH for Python 3.6
# The original version is saved in .bash_profile.pysave
PATH="/Library/Frameworks/Python.framework/Versions/3.7/bin:${PATH}"
export PATH

# added by Anaconda2 4.4.0 installer
export PATH="/Users/brandonnguyen/anaconda/bin:$PATH"

# added by Anaconda3 4.4.0 installer
export PATH="/Users/brandonnguyen/anaconda/bin:$PATH"

# Setting PATH for Python 3.7
# The original version is saved in .bash_profile.pysave
PATH="/Library/Frameworks/Python.framework/Versions/3.7/bin:${PATH}"
export PATH

export PATH=/usr/local/bin:$PATH

export VIRTUALENVWRAPPER_PYTHON=/usr/local/bin/python3
export WORKON_HOME=$HOME/.virtualenvsexport
PROJECT_HOME=$HOME/Devel
source /usr/local/bin/virtualenvwrapper.sh

# System shortcuts
alias ll="ls -la"
alias c="clear"

# Git shortcuts
alias g="git"
alias gf="git fetch"
alias gpll="git pull"
alias gp="git push"
alias gs="git status"
alias ga="git add"
alias gaa="git add --all"
alias gau="git add -u"
alias gc="git commit"
alias gcm="git commit -m"
alias gb="git branch"
alias gba="git branch --all"
alias gbr="git branch --remote"
alias gcout="git checkout"
alias gcoutb="git checkout -b"
alias gr="git reset"
alias grh="git reset --hard"
alias gl="git log"
alias gla="git log --all"
alias glo="git log --oneline"
alias glao="git log --all --oneline"
alias glg="git log --graph --abbrev-commit --decorate --format=format:'%C(bold blue)%h%C(reset) - %C(bold green)(%ar)%C(reset) %C(white)%s%C(reset) %C(dim white)- %an%C(reset)%C(bold yellow)%d%C(reset)' --all"
alias gm="git merge"

# Docker shortcuts
alias d='docker'
alias di='docker images'
alias dps='docker ps'
alias dpsa='docker ps -a'
alias db='docker build'
alias db.='docker build .'
alias db.t='docker build . -t'
alias dcup='docker-compose up'
alias dcupb='docker-compose up --build'
alias dcd='docker-compose down'
alias drmn='docker rmi $(docker images -f "dangling=true" -q)'
alias drmca='docker rm $(docker ps -a -q)'
alias drmi='docker rmi'
alias drp='docker run -p'

# K8s shortcuts
alias k="kubectl"
alias ka="kubectl apply -f"
alias kc="kubectl create -f"
alias kdel="kubectl delete"
alias kg="kubectl get"
alias kpo="kubectl get pods"
alias kno="kubectl get nodes"
alias kdep="kubectl get deployments"
alias ksvc="kubectl get svc"
alias kds="kubectl get daemonset"
alias kns="kubectl get ns"
alias kdsc="kubectl describe"
alias klog="kubectl logs"

# MongoDB shortcuts
alias mongorunfg="mongod --config /usr/local/etc/mongod.conf"
alias mongorunbg="mongod --config /usr/local/etc/mongod.conf --fork"
alias mongorunsvc="brew services start mongodb-community@4.2"
